Schweiz: ZÜRICH;BERN / BERNE;LUZERN;URI;SCHWYZ;OBWALDEN;NIDWALDEN;GLARUS;ZUG;FRIBOURG / FREIBURG;SOLOTHURN;BASEL-STADT;BASEL-LANDSCHAFT;SCHAFFHAUSEN;APPENZELL AUSSERRHODEN;APPENZELL INNERRHODEN;ST. GALLEN;GRAUBÜNDEN / GRIGIONI / GRISCHUN;AARGAU;THURGAU;TICINO;VAUD;VALAIS / WALLIS;NEUCHÂTEL;GENÈVE;JURA
ZÜRICH: Bezirk Affoltern;Bezirk Andelfingen;Bezirk Bülach;Bezirk Dielsdorf;Bezirk Hinwil;Bezirk Horgen;Bezirk Meilen;Bezirk Pfäffikon;Bezirk Uster;Bezirk Winterthur;Bezirk Dietikon;Bezirk Zürich
BERN / BERNE: Arrondissement administratif Jura bernois;Verwaltungskreis Biel/Bienne;Verwaltungskreis Seeland;Verwaltungskreis Oberaargau;Verwaltungskreis Emmental;Verwaltungskreis Bern-Mittelland;Verwaltungskreis Thun;Verwaltungskreis Obersimmental-Saanen;Verwaltungskreis Frutigen-Niedersimmental;Verwaltungskreis Interlaken-Oberhasli
LUZERN: Wahlkreis Luzern-Stadt;Wahlkreis Luzern-Land;Wahlkreis Hochdorf;Wahlkreis Sursee;Wahlkreis Willisau;Wahlkreis Entlebuch;LU-Ausland-CH
URI: Kanton Uri;UR-Ausland-CH
SCHWYZ: Bezirk Einsiedeln;Bezirk Gersau;Bezirk Höfe;Bezirk Küssnacht (SZ);Bezirk March;Bezirk Schwyz
OBWALDEN: Kanton Obwalden
NIDWALDEN: Kanton Nidwalden
GLARUS: Kanton Glarus
ZUG: Kanton Zug
FRIBOURG / FREIBURG: District de la Broye;District de la Glâne;District de la Gruyère;District de la Sarine;Bezirk See / District du Lac;Bezirk Sense;District de la Veveyse
SOLOTHURN: Bezirk Gäu;Bezirk Thal;Bezirk Bucheggberg;Bezirk Dorneck;Bezirk Gösgen;Bezirk Wasseramt;Bezirk Lebern;Bezirk Olten;Bezirk Solothurn;Bezirk Thierstein
BASEL-STADT: Kanton Basel-Stadt;BS-Ausland-CH
BASEL-LANDSCHAFT: Bezirk Arlesheim;Bezirk Laufen;Bezirk Liestal;Bezirk Sissach;Bezirk Waldenburg
SCHAFFHAUSEN: Bezirk Oberklettgau;Bezirk Reiat;Bezirk Schaffhausen;Bezirk Schleitheim;Bezirk Stein;Bezirk Unterklettgau
APPENZELL AUSSERRHODEN: Bezirk Hinterland;Bezirk Mittelland;Bezirk Vorderland
APPENZELL INNERRHODEN: Kanton Appenzell Innerrhoden;AI-Ausland-CH
ST. GALLEN: Wahlkreis St. Gallen;Wahlkreis Rorschach;Wahlkreis Rheintal;Wahlkreis Werdenberg;Wahlkreis Sarganserland;Wahlkreis See-Gaster;Wahlkreis Toggenburg;Wahlkreis Wil;SG-Ausland-CH
GRAUBÜNDEN / GRIGIONI / GRISCHUN: Region Albula;Region Bernina;Region Engiadina Bassa / Val Müstair;Region Imboden;Region Landquart;Region Maloja;Region Moesa;Region Plessur;Region Prättigau / Davos;Region Surselva;Region Viamala
AARGAU: Bezirk Aarau;Bezirk Baden;Bezirk Bremgarten;Bezirk Brugg;Bezirk Kulm;Bezirk Laufenburg;Bezirk Lenzburg;Bezirk Muri;Bezirk Rheinfelden;Bezirk Zofingen;Bezirk Zurzach;AG-Ausland-CH
THURGAU: Bezirk Arbon;Bezirk Frauenfeld;Bezirk Kreuzlingen;Bezirk Münchwilen;Bezirk Weinfelden;TG-Ausland-CH
TICINO: Distretto di Bellinzona;Distretto di Blenio;Distretto di Leventina;Distretto di Locarno;Distretto di Lugano;Distretto di Mendrisio;Distretto di Riviera;Distretto di Vallemaggia
VAUD: District d'Aigle;District de la Broye-Vully;District du Gros-de-Vaud;District du Jura-Nord vaudois;District de Lausanne;District de Lavaux-Oron;District de Morges;District de Nyon;District de l'Ouest lausannois;District de la Riviera-Pays-d'Enhaut;VD-CH de l'étranger
VALAIS / WALLIS: Bezirk Brig;District de Conthey;District d'Entremont;Bezirk Goms;District d'Hérens;Bezirk Leuk;District de Martigny;District de Monthey;Bezirk Raron;District de Saint-Maurice;District de Sierre;District de Sion;Bezirk Visp
NEUCHÂTEL: Canton de Neuchâtel
GENÈVE: Canton de Genève;GE-CH de l'étranger
JURA: District de Delémont;District des Franches-Montagnes;District de Porrentruy

Bezirk Affoltern: Aeugst am Albis;Affoltern am Albis;Bonstetten;Hausen am Albis;Hedingen;Kappel am Albis;Knonau;Maschwanden;Mettmenstetten;Obfelden;Ottenbach;Rifferswil;Stallikon;Wettswil am Albis
Bezirk Andelfingen: Benken (ZH);Berg am Irchel;Buch am Irchel;Dachsen;Dorf;Feuerthalen;Flaach;Flurlingen;Henggart;Kleinandelfingen;Laufen-Uhwiesen;Marthalen;Ossingen;Rheinau;Thalheim an der Thur;Trüllikon;Truttikon;Volken;Andelfingen;Stammheim
Bezirk Bülach: Bachenbülach;Bassersdorf;Bülach;Dietlikon;Eglisau;Embrach;Freienstein-Teufen;Glattfelden;Hochfelden;Höri;Hüntwangen;Kloten;Lufingen;Nürensdorf;Oberembrach;Opfikon;Rafz;Rorbas;Wallisellen;Wasterkingen;Wil (ZH);Winkel
Bezirk Dielsdorf: Bachs;Boppelsen;Buchs (ZH);Dällikon;Dänikon;Dielsdorf;Hüttikon;Neerach;Niederglatt;Niederhasli;Niederweningen;Oberglatt;Oberweningen;Otelfingen;Regensberg;Regensdorf;Rümlang;Schleinikon;Schöfflisdorf;Stadel;Steinmaur;Weiach
Bezirk Hinwil: Bäretswil;Bubikon;Dürnten;Fischenthal;Gossau (ZH);Grüningen;Hinwil;Rüti (ZH);Seegräben;Wald (ZH);Wetzikon (ZH)
Bezirk Horgen: Adliswil;Kilchberg (ZH);Langnau am Albis;Oberrieden;Richterswil;Rüschlikon;Thalwil;Wädenswil;Horgen
Bezirk Meilen: Erlenbach (ZH);Herrliberg;Hombrechtikon;Küsnacht (ZH);Männedorf;Meilen;Oetwil am See;Stäfa;Uetikon am See;Zumikon;Zollikon
Bezirk Pfäffikon: Fehraltorf;Hittnau;Lindau;Pfäffikon;Russikon;Weisslingen;Wila;Wildberg;Illnau-Effretikon;Bauma
Bezirk Uster: Dübendorf;Egg;Fällanden;Greifensee;Maur;Mönchaltorf;Schwerzenbach;Uster;Volketswil;Wangen-Brüttisellen
Bezirk Winterthur: Altikon;Brütten;Dägerlen;Dättlikon;Dinhard;Ellikon an der Thur;Elsau;Hagenbuch;Hettlingen;Neftenbach;Pfungen;Rickenbach (ZH);Schlatt (ZH);Seuzach;Turbenthal;Winterthur;Zell (ZH);Elgg;Wiesendangen
Bezirk Dietikon: Aesch (ZH);Birmensdorf (ZH);Dietikon;Geroldswil;Oberengstringen;Oetwil an der Limmat;Schlieren;Uitikon;Unterengstringen;Urdorf;Weiningen (ZH)
Bezirk Zürich: Zürich
Arrondissement administratif Jura bernois: Corgémont;Cormoret;Cortébert;Courtelary;La Ferrière;Mont-Tramelan;Orvin;Renan (BE);Romont (BE);Saint-Imier;Sonceboz-Sombeval;Sonvilier;Tramelan;Villeret;Sauge;Péry-La Heutte;Belprahon;Champoz;Corcelles (BE);Court;Crémines;Eschert;Grandval;Loveresse;Moutier;Perrefitte;Reconvilier;Roches (BE);Saicourt;Saules (BE);Schelten;Seehof;Sorvilier;Tavannes;Rebévelier;Petit-Val;Valbirse;La Neuveville;Nods;Plateau de Diesse
Verwaltungskreis Biel/Bienne: Biel/Bienne;Evilard;Lengnau (BE);Meinisberg;Pieterlen;Aegerten;Bellmund;Brügg;Ipsach;Ligerz;Mörigen;Nidau;Orpund;Port;Safnern;Scheuren;Schwadernau;Sutz-Lattrigen;Twann-Tüscherz
Verwaltungskreis Seeland: Aarberg;Bargen (BE);Grossaffoltern;Kallnach;Kappelen;Lyss;Radelfingen;Rapperswil (BE);Schüpfen;Seedorf (BE);Arch;Büetigen;Büren an der Aare;Diessbach bei Büren;Dotzigen;Leuzigen;Oberwil bei Büren;Rüti bei Büren;Wengi;Brüttelen;Erlach;Finsterhennen;Gals;Gampelen;Ins;Lüscherz;Müntschemier;Siselen;Treiten;Tschugg;Vinelz;Bühl;Epsach;Hagneck;Hermrigen;Jens;Merzligen;Studen (BE);Täuffelen;Walperswil;Worben
Verwaltungskreis Oberaargau: Aarwangen;Auswil;Bannwil;Bleienbach;Busswil bei Melchnau;Gondiswil;Langenthal;Lotzwil;Madiswil;Melchnau;Oeschenbach;Reisiswil;Roggwil (BE);Rohrbach;Rohrbachgraben;Rütschelen;Schwarzhäusern;Thunstetten;Ursenbach;Wynau;Eriswil;Huttwil;Walterswil (BE);Wyssachen;Attiswil;Berken;Bettenhausen;Farnern;Graben;Heimenhausen;Herzogenbuchsee;Inkwil;Niederbipp;Niederönz;Oberbipp;Ochlenberg;Rumisberg;Seeberg;Thörigen;Walliswil bei Niederbipp;Walliswil bei Wangen;Wangen an der Aare;Wangenried;Wiedlisbach
Verwaltungskreis Emmental: Aefligen;Alchenstorf;Burgdorf;Ersigen;Hasle bei Burgdorf;Heimiswil;Hindelbank;Höchstetten;Kernenried;Kirchberg (BE);Koppigen;Krauchthal;Lyssach;Oberburg;Rüdtligen-Alchenflüh;Rumendingen;Willadingen;Wynigen;Bätterkinden;Utzenstorf;Wiler bei Utzenstorf;Zielebach;Eggiwil;Langnau im Emmental;Lauperswil;Röthenbach im Emmental;Rüderswil;Schangnau;Signau;Trub;Trubschachen;Affoltern im Emmental;Dürrenroth;Lützelflüh;Rüegsau;Sumiswald;Trachselwald
Verwaltungskreis Bern-Mittelland: Meikirch;Bern;Bolligen;Bremgarten bei Bern;Kirchlindach;Köniz;Muri bei Bern;Oberbalm;Stettlen;Vechigen;Wohlen bei Bern;Zollikofen;Ittigen;Ostermundigen;Bäriswil;Fraubrunnen;Jegenstorf;Iffwil;Mattstetten;Moosseedorf;Münchenbuchsee;Urtenen-Schönbühl;Wiggiswil;Zuzwil (BE);Arni (BE);Biglen;Bowil;Brenzikofen;Freimettigen;Grosshöchstetten;Häutligen;Herbligen;Kiesen;Konolfingen;Landiswil;Linden;Mirchel;Münsingen;Niederhünigen;Oberdiessbach;Oberthal;Oppligen;Rubigen;Walkringen;Worb;Zäziwil;Oberhünigen;Allmendingen;Wichtrach;Ferenbalm;Frauenkappelen;Gurbrü;Kriechenwil;Laupen;Mühleberg;Münchenwiler;Neuenegg;Wileroltigen;Guggisberg;Rüschegg;Schwarzenburg;Belp;Gerzensee;Kaufdorf;Kehrsatz;Kirchdorf (BE);Riggisberg;Rüeggisberg;Toffen;Wald (BE);Thurnen
Verwaltungskreis Thun: Reutigen;Stocken-Höfen;Burgistein;Gurzelen;Seftigen;Uttigen;Wattenwil;Amsoldingen;Blumenstein;Buchholterberg;Eriz;Fahrni;Heiligenschwendi;Heimberg;Hilterfingen;Homberg;Horrenbach-Buchen;Oberhofen am Thunersee;Oberlangenegg;Pohlern;Sigriswil;Steffisburg;Teuffenthal (BE);Thierachern;Thun;Uebeschi;Uetendorf;Unterlangenegg;Wachseldorn;Zwieselberg;Forst-Längenbühl
Verwaltungskreis Obersimmental-Saanen: Boltigen;Lenk;St. Stephan;Zweisimmen;Gsteig;Lauenen;Saanen
Verwaltungskreis Frutigen-Niedersimmental: Adelboden;Aeschi bei Spiez;Frutigen;Kandergrund;Kandersteg;Krattigen;Reichenbach im Kandertal;Därstetten;Diemtigen;Erlenbach im Simmental;Oberwil im Simmental;Spiez;Wimmis
Verwaltungskreis Interlaken-Oberhasli: Beatenberg;Bönigen;Brienz (BE);Brienzwiler;Därligen;Grindelwald;Gsteigwiler;Gündlischwand;Habkern;Hofstetten bei Brienz;Interlaken;Iseltwald;Lauterbrunnen;Leissigen;Lütschental;Matten bei Interlaken;Niederried bei Interlaken;Oberried am Brienzersee;Ringgenberg (BE);Saxeten;Schwanden bei Brienz;Unterseen;Wilderswil;Guttannen;Hasliberg;Innertkirchen;Meiringen;Schattenhalb
Wahlkreis Luzern-Stadt: Luzern
Wahlkreis Luzern-Land: Adligenswil;Buchrain;Dierikon;Ebikon;Gisikon;Greppen;Honau;Horw;Kriens;Malters;Meggen;Meierskappel;Root;Schwarzenberg;Udligenswil;Vitznau;Weggis
Wahlkreis Hochdorf: Aesch (LU);Ballwil;Emmen;Ermensee;Eschenbach (LU);Hitzkirch;Hochdorf;Hohenrain;Inwil;Rain;Römerswil;Rothenburg;Schongau
Wahlkreis Sursee: Beromünster;Büron;Buttisholz;Eich;Geuensee;Grosswangen;Hildisrieden;Knutwil;Mauensee;Neuenkirch;Nottwil;Oberkirch;Rickenbach (LU);Ruswil;Schenkon;Schlierbach;Sempach;Sursee;Triengen
Wahlkreis Willisau: Alberswil;Altbüron;Altishofen;Dagmersellen;Egolzwil;Ettiswil;Fischbach;Grossdietwil;Hergiswil bei Willisau;Luthern;Menznau;Nebikon;Pfaffnau;Reiden;Roggliswil;Schötz;Ufhusen;Wauwil;Wikon;Zell (LU);Willisau
Wahlkreis Entlebuch: Doppleschwand;Entlebuch;Flühli;Hasle (LU);Romoos;Schüpfheim;Werthenstein;Escholzmatt-Marbach;Wolhusen
Kanton Uri: Altdorf (UR);Andermatt;Attinghausen;Bürglen (UR);Erstfeld;Flüelen;Göschenen;Gurtnellen;Hospental;Isenthal;Realp;Schattdorf;Seedorf (UR);Seelisberg;Silenen;Sisikon;Spiringen;Unterschächen;Wassen
Bezirk Einsiedeln: Einsiedeln
Bezirk Gersau: Gersau
Bezirk Höfe: Feusisberg;Freienbach;Wollerau
Bezirk Küssnacht (SZ): Küssnacht (SZ)
Bezirk March: Altendorf;Galgenen;Innerthal;Lachen;Reichenburg;Schübelbach;Tuggen;Vorderthal;Wangen (SZ)
Bezirk Schwyz: Alpthal;Arth;Illgau;Ingenbohl;Lauerz;Morschach;Muotathal;Oberiberg;Riemenstalden;Rothenthurm;Sattel;Schwyz;Steinen;Steinerberg;Unteriberg
Kanton Obwalden: Alpnach;Engelberg;Giswil;Kerns;Lungern;Sachseln;Sarnen
Kanton Nidwalden: Beckenried;Buochs;Dallenwil;Emmetten;Ennetbürgen;Ennetmoos;Hergiswil (NW);Oberdorf (NW);Stans;Stansstad;Wolfenschiessen
Kanton Glarus: Glarus Nord;Glarus Süd;Glarus
Kanton Zug: Baar;Cham;Hünenberg;Menzingen;Neuheim;Oberägeri;Risch;Steinhausen;Unterägeri;Walchwil;Zug
District de la Broye: Châtillon (FR);Cugy (FR);Fétigny;Gletterens;Lully (FR);Ménières;Montagny (FR);Nuvilly;Prévondavaux;Saint-Aubin (FR);Sévaz;Surpierre;Vallon;Les Montets;Delley-Portalban;Belmont-Broye;Estavayer;Cheyres-Châbles
District de la Glâne: Auboranges;Billens-Hennens;Chapelle (Glâne);Le Châtelard;Châtonnaye;Ecublens (FR);Grangettes;Massonnens;Mézières (FR);Montet (Glâne);Romont (FR);Rue;Siviriez;Ursy;Vuisternens-devant-Romont;Villorsonnens;Torny;Villaz
District de la Gruyère: Haut-Intyamon;Pont-en-Ogoz;Botterens;Broc;Bulle;Châtel-sur-Montsalvens;Corbières;Crésuz;Echarlens;Grandvillard;Gruyères;Hauteville;Jaun;Marsens;Morlon;Le Pâquier (FR);Pont-la-Ville;Riaz;La Roche;Sâles;Sorens;Vaulruz;Vuadens;Bas-Intyamon;Val-de-Charmey
District de la Sarine: Autigny;Avry;Belfaux;Chénens;Corminboeuf;Cottens (FR);Ferpicloz;Fribourg;Givisiez;Granges-Paccot;Grolley;Marly;Matran;Neyruz (FR);Pierrafortscha;Ponthaux;Le Mouret;Treyvaux;Villars-sur-Glâne;Villarsel-sur-Marly;Hauterive (FR);La Brillaz;La Sonnaz;Gibloux;Prez;Bois-d'Amont
Bezirk See / District du Lac: Courgevaux;Courtepin;Cressier (FR);Fräschels;Greng;Gurmels;Kerzers;Kleinbösingen;Meyriez;Misery-Courtion;Muntelier;Murten;Ried bei Kerzers;Ulmiz;Mont-Vully
Bezirk Sense: Brünisried;Düdingen;Giffers;Bösingen;Heitenried;Plaffeien;Plasselb;Rechthalten;St. Silvester;St. Ursen;Schmitten (FR);Tafers;Tentlingen;Ueberstorf;Wünnewil-Flamatt
District de la Veveyse: Attalens;Bossonnens;Châtel-Saint-Denis;Granges (Veveyse);Remaufens;Saint-Martin (FR);Semsales;Le Flon;La Verrerie
Bezirk Gäu: Egerkingen;Härkingen;Kestenholz;Neuendorf;Niederbuchsiten;Oberbuchsiten;Oensingen;Wolfwil
Bezirk Thal: Aedermannsdorf;Balsthal;Herbetswil;Holderbank (SO);Laupersdorf;Matzendorf;Mümliswil-Ramiswil;Welschenrohr-Gänsbrunnen
Bezirk Bucheggberg: Biezwil;Lüterkofen-Ichertswil;Lüterswil-Gächliwil;Messen;Schnottwil;Unterramsern;Lüsslingen-Nennigkofen;Buchegg
Bezirk Dorneck: Bättwil;Büren (SO);Dornach;Gempen;Hochwald;Hofstetten-Flüh;Metzerlen-Mariastein;Nuglar-St. Pantaleon;Rodersdorf;Seewen;Witterswil
Bezirk Gösgen: Hauenstein-Ifenthal;Kienberg;Lostorf;Niedergösgen;Obergösgen;Stüsslingen;Trimbach;Winznau;Wisen (SO);Erlinsbach (SO)
Bezirk Wasseramt: Aeschi (SO);Biberist;Bolken;Deitingen;Derendingen;Etziken;Gerlafingen;Halten;Horriwil;Hüniken;Kriegstetten;Lohn-Ammannsegg;Luterbach;Obergerlafingen;Oekingen;Recherswil;Subingen;Zuchwil;Drei Höfe
Bezirk Lebern: Balm bei Günsberg;Bellach;Bettlach;Feldbrunnen-St. Niklaus;Flumenthal;Grenchen;Günsberg;Hubersdorf;Kammersrohr;Langendorf;Lommiswil;Oberdorf (SO);Riedholz;Rüttenen;Selzach
Bezirk Olten: Boningen;Däniken;Dulliken;Eppenberg-Wöschnau;Fulenbach;Gretzenbach;Gunzgen;Hägendorf;Kappel (SO);Olten;Rickenbach (SO);Schönenwerd;Starrkirch-Wil;Walterswil (SO);Wangen bei Olten
Bezirk Solothurn: Solothurn
Bezirk Thierstein: Bärschwil;Beinwil (SO);Breitenbach;Büsserach;Erschwil;Fehren;Grindel;Himmelried;Kleinlützel;Meltingen;Nunningen;Zullwil
Kanton Basel-Stadt: Basel;Bettingen;Riehen
Bezirk Arlesheim: Aesch (BL);Allschwil;Arlesheim;Biel-Benken;Binningen;Birsfelden;Bottmingen;Ettingen;Münchenstein;Muttenz;Oberwil (BL);Pfeffingen;Reinach (BL);Schönenbuch;Therwil
Bezirk Laufen: Blauen;Brislach;Burg im Leimental;Dittingen;Duggingen;Grellingen;Laufen;Liesberg;Nenzlingen;Roggenburg;Röschenz;Wahlen;Zwingen
Bezirk Liestal: Arisdorf;Augst;Bubendorf;Frenkendorf;Füllinsdorf;Giebenach;Hersberg;Lausen;Liestal;Lupsingen;Pratteln;Ramlinsburg;Seltisberg;Ziefen
Bezirk Sissach: Anwil;Böckten;Buckten;Buus;Diepflingen;Gelterkinden;Häfelfingen;Hemmiken;Itingen;Känerkinden;Kilchberg (BL);Läufelfingen;Maisprach;Nusshof;Oltingen;Ormalingen;Rickenbach (BL);Rothenfluh;Rümlingen;Rünenberg;Sissach;Tecknau;Tenniken;Thürnen;Wenslingen;Wintersingen;Wittinsburg;Zeglingen;Zunzgen
Bezirk Waldenburg: Arboldswil;Bennwil;Bretzwil;Diegten;Eptingen;Hölstein;Lampenberg;Langenbruck;Lauwil;Liedertswil;Niederdorf;Oberdorf (BL);Reigoldswil;Titterten;Waldenburg
Bezirk Oberklettgau: Gächlingen;Löhningen;Neunkirch
Bezirk Reiat: Büttenhardt;Dörflingen;Lohn (SH);Stetten (SH);Thayngen
Bezirk Schaffhausen: Bargen (SH);Beringen;Buchberg;Merishausen;Neuhausen am Rheinfall;Rüdlingen;Schaffhausen
Bezirk Schleitheim: Beggingen;Schleitheim;Siblingen
Bezirk Stein: Buch (SH);Hemishofen;Ramsen;Stein am Rhein
Bezirk Unterklettgau: Hallau;Oberhallau;Trasadingen;Wilchingen
Bezirk Hinterland: Herisau;Hundwil;Schönengrund;Schwellbrunn;Stein (AR);Urnäsch;Waldstatt
Bezirk Mittelland: Bühler;Gais;Speicher;Teufen (AR);Trogen
Bezirk Vorderland: Grub (AR);Heiden;Lutzenberg;Rehetobel;Reute (AR);Wald (AR);Walzenhausen;Wolfhalden
Kanton Appenzell Innerrhoden: Appenzell;Gonten;Schlatt-Haslen;Oberegg;Schwende-Rüte
Wahlkreis St. Gallen: Häggenschwil;Muolen;St. Gallen;Wittenbach;Eggersriet;Andwil (SG);Gaiserwald;Gossau (SG);Waldkirch
Wahlkreis Rorschach: Berg (SG);Goldach;Mörschwil;Rorschach;Rorschacherberg;Steinach;Tübach;Untereggen;Thal
Wahlkreis Rheintal: Au (SG);Balgach;Berneck;Diepoldsau;Rheineck;St. Margrethen;Widnau;Altstätten;Eichberg;Marbach (SG);Oberriet (SG);Rebstein;Rüthi (SG)
Wahlkreis Werdenberg: Buchs (SG);Gams;Grabs;Sennwald;Sevelen;Wartau
Wahlkreis Sarganserland: Bad Ragaz;Flums;Mels;Pfäfers;Quarten;Sargans;Vilters-Wangs;Walenstadt
Wahlkreis See-Gaster: Amden;Benken (SG);Kaltbrunn;Schänis;Weesen;Schmerikon;Uznach;Rapperswil-Jona;Gommiswald;Eschenbach (SG)
Wahlkreis Toggenburg: Ebnat-Kappel;Wildhaus-Alt St. Johann;Nesslau;Lichtensteig;Wattwil;Kirchberg (SG);Lütisburg;Mosnang;Bütschwil-Ganterschwil;Neckertal
Wahlkreis Wil: Degersheim;Flawil;Jonschwil;Oberuzwil;Uzwil;Niederbüren;Niederhelfenschwil;Oberbüren;Zuzwil (SG);Wil (SG)
Region Albula: Vaz/Obervaz;Lantsch/Lenz;Schmitten (GR);Albula/Alvra;Surses;Bergün Filisur
Region Bernina: Brusio;Poschiavo
Region Engiadina Bassa / Val Müstair: Zernez;Samnaun;Scuol;Valsot;Val Müstair
Region Imboden: Bonaduz;Domat/Ems;Rhäzüns;Felsberg;Flims;Tamins;Trin
Region Landquart: Trimmis;Untervaz;Zizers;Fläsch;Jenins;Maienfeld;Malans;Landquart
Region Maloja: Bever;Celerina/Schlarigna;Madulain;Pontresina;La Punt Chamues-ch;Samedan;St. Moritz;S-chanf;Sils im Engadin/Segl;Silvaplana;Zuoz;Bregaglia
Region Moesa: Buseno;Castaneda;Rossa;Santa Maria in Calanca;Lostallo;Mesocco;Soazza;Cama;Grono;Roveredo (GR);San Vittore;Calanca
Region Plessur: Chur;Churwalden;Arosa;Tschiertschen-Praden
Region Prättigau / Davos: Davos;Fideris;Furna;Jenaz;Klosters;Conters im Prättigau;Küblis;Luzein;Grüsch;Schiers;Seewis im Prättigau
Region Surselva: Falera;Laax;Sagogn;Schluein;Vals;Lumnezia;Ilanz/Glion;Safiental;Breil/Brigels;Disentis/Mustér;Medel (Lucmagn);Sumvitg;Tujetsch;Trun;Obersaxen Mundaun
Region Viamala: Fürstenau;Rothenbrunnen;Scharans;Sils im Domleschg;Cazis;Flerden;Masein;Thusis;Tschappina;Urmein;Domleschg;Avers;Sufers;Andeer;Rongellen;Zillis-Reischen;Ferrera;Rheinwald;Muntogna da Schons
Bezirk Aarau: Aarau;Biberstein;Buchs (AG);Densbüren;Erlinsbach (AG);Gränichen;Hirschthal;Küttigen;Muhen;Oberentfelden;Suhr;Unterentfelden
Bezirk Baden: Baden;Bellikon;Bergdietikon;Birmenstorf (AG);Ennetbaden;Fislisbach;Freienwil;Gebenstorf;Killwangen;Künten;Mägenwil;Mellingen;Neuenhof;Niederrohrdorf;Oberrohrdorf;Obersiggenthal;Remetschwil;Spreitenbach;Stetten (AG);Turgi;Untersiggenthal;Wettingen;Wohlenschwil;Würenlingen;Würenlos;Ehrendingen
Bezirk Bremgarten: Arni (AG);Berikon;Bremgarten (AG);Büttikon;Dottikon;Eggenwil;Fischbach-Göslikon;Hägglingen;Jonen;Niederwil (AG);Oberlunkhofen;Oberwil-Lieli;Rudolfstetten-Friedlisberg;Sarmenstorf;Tägerig;Uezwil;Unterlunkhofen;Villmergen;Widen;Wohlen (AG);Zufikon;Islisberg
Bezirk Brugg: Auenstein;Birr;Birrhard;Brugg;Habsburg;Hausen (AG);Lupfig;Mandach;Mönthal;Mülligen;Remigen;Riniken;Rüfenach;Thalheim (AG);Veltheim (AG);Villigen;Villnachern;Windisch;Bözberg;Schinznach
Bezirk Kulm: Beinwil am See;Birrwil;Dürrenäsch;Gontenschwil;Holziken;Leimbach (AG);Leutwil;Menziken;Oberkulm;Reinach (AG);Schlossrued;Schmiedrued;Schöftland;Teufenthal (AG);Unterkulm;Zetzwil
Bezirk Laufenburg: Eiken;Frick;Gansingen;Gipf-Oberfrick;Kaisten;Laufenburg;Münchwilen (AG);Oberhof;Oeschgen;Schwaderloch;Sisseln;Wittnau;Wölflinswil;Zeihen;Mettauertal;Böztal;Herznach-Ueken
Bezirk Lenzburg: Ammerswil;Boniswil;Brunegg;Dintikon;Egliswil;Fahrwangen;Hallwil;Hendschiken;Holderbank (AG);Hunzenschwil;Lenzburg;Meisterschwanden;Möriken-Wildegg;Niederlenz;Othmarsingen;Rupperswil;Schafisheim;Seengen;Seon;Staufen
Bezirk Muri: Abtwil;Aristau;Auw;Beinwil (Freiamt);Besenbüren;Bettwil;Boswil;Bünzen;Buttwil;Dietwil;Geltwil;Kallern;Merenschwand;Mühlau;Muri (AG);Oberrüti;Rottenschwil;Sins;Waltenschwil
Bezirk Rheinfelden: Hellikon;Kaiseraugst;Magden;Möhlin;Mumpf;Obermumpf;Olsberg;Rheinfelden;Schupfart;Stein (AG);Wallbach;Wegenstetten;Zeiningen;Zuzgen
Bezirk Zofingen: Aarburg;Bottenwil;Brittnau;Kirchleerau;Kölliken;Moosleerau;Murgenthal;Oftringen;Reitnau;Rothrist;Safenwil;Staffelbach;Strengelbach;Uerkheim;Vordemwald;Wiliberg;Zofingen
Bezirk Zurzach: Böttstein;Döttingen;Endingen;Fisibach;Full-Reuenthal;Klingnau;Koblenz;Leibstadt;Lengnau (AG);Leuggern;Mellikon;Schneisingen;Siglistorf;Tegerfelden;Zurzach
Bezirk Arbon: Arbon;Dozwil;Egnach;Hefenhofen;Horn;Kesswil;Roggwil (TG);Romanshorn;Salmsach;Sommeri;Uttwil;Amriswil
Bezirk Frauenfeld: Basadingen-Schlattingen;Diessenhofen;Schlatt (TG);Felben-Wellhausen;Frauenfeld;Gachnang;Hüttlingen;Matzingen;Neunforn;Stettfurt;Thundorf;Uesslingen-Buch;Warth-Weiningen;Berlingen;Eschenz;Herdern;Homburg;Hüttwilen;Mammern;Müllheim;Pfyn;Steckborn;Wagenhausen
Bezirk Kreuzlingen: Altnau;Bottighofen;Ermatingen;Gottlieben;Güttingen;Kemmental;Kreuzlingen;Langrickenbach;Lengwil;Münsterlingen;Tägerwilen;Wäldi;Raperswilen;Salenstein
Bezirk Münchwilen: Aadorf;Bettwiesen;Bichelsee-Balterswil;Braunau;Eschlikon;Fischingen;Lommis;Münchwilen (TG);Rickenbach (TG);Sirnach;Tobel-Tägerschen;Wängi;Wilen (TG)
Bezirk Weinfelden: Bischofszell;Erlen;Hauptwil-Gottshaus;Hohentannen;Kradolf-Schönenberg;Sulgen;Zihlschlacht-Sitterdorf;Affeltrangen;Schönholzerswilen;Wuppenau;Amlikon-Bissegg;Berg (TG);Birwinken;Bürglen (TG);Bussnang;Märstetten;Weinfelden;Wigoltingen
Distretto di Bellinzona: Arbedo-Castione;Bellinzona;Cadenazzo;Isone;Lumino;Sant'Antonino
Distretto di Blenio: Acquarossa;Blenio;Serravalle
Distretto di Leventina: Airolo;Bedretto;Bodio;Dalpe;Faido;Giornico;Personico;Pollegio;Prato (Leventina);Quinto
Distretto di Locarno: Ascona;Brione sopra Minusio;Brissago;Gordola;Lavertezzo;Locarno;Losone;Mergoscia;Minusio;Muralto;Orselina;Ronco sopra Ascona;Tenero-Contra;Onsernone;Cugnasco-Gerra;Terre di Pedemonte;Centovalli;Gambarogno;Verzasca
Distretto di Lugano: Agno;Aranno;Arogno;Astano;Bedano;Bedigliora;Bioggio;Bissone;Brusino Arsizio;Cademario;Cadempino;Canobbio;Caslano;Comano;Cureglia;Curio;Grancia;Gravesano;Lamone;Lugano;Magliaso;Manno;Massagno;Melide;Mezzovico-Vira;Miglieglia;Morcote;Muzzano;Neggio;Novaggio;Origlio;Paradiso;Ponte Capriasca;Porza;Pura;Savosa;Sorengo;Capriasca;Torricella-Taverne;Vernate;Vezia;Vico Morcote;Collina d'Oro;Alto Malcantone;Monteceneri;Tresa;Val Mara
Distretto di Mendrisio: Balerna;Castel San Pietro;Chiasso;Coldrerio;Mendrisio;Morbio Inferiore;Novazzano;Riva San Vitale;Stabio;Vacallo;Breggia
Distretto di Riviera: Biasca;Riviera
Distretto di Vallemaggia: Bosco/Gurin;Campo (Vallemaggia);Cerentino;Cevio;Linescio;Maggia;Lavizzara;Avegno Gordevio
District d'Aigle: Aigle;Bex;Chessel;Corbeyrier;Gryon;Lavey-Morcles;Leysin;Noville;Ollon;Ormont-Dessous;Ormont-Dessus;Rennaz;Roche (VD);Villeneuve (VD);Yvorne
District de la Broye-Vully: Avenches;Cudrefin;Faoug;Vully-les-Lacs;Bussy-sur-Moudon;Chavannes-sur-Moudon;Curtilles;Dompierre (VD);Hermenches;Lovatens;Lucens;Moudon;Prévonloup;Rossenges;Syens;Villars-le-Comte;Vucherens;Corcelles-le-Jorat;Ropraz;Vulliens;Champtauroz;Chevroux;Corcelles-près-Payerne;Grandcour;Henniez;Missy;Payerne;Trey;Treytorrens (Payerne);Villarzel;Valbroye
District du Gros-de-Vaud: Bettens;Bournens;Boussens;Daillens;Lussery-Villars;Mex (VD);Penthalaz;Penthaz;Sullens;Vufflens-la-Ville;Assens;Bercher;Bottens;Bretigny-sur-Morrens;Cugy (VD);Echallens;Essertines-sur-Yverdon;Etagnières;Fey;Froideville;Morrens (VD);Oulens-sous-Echallens;Pailly;Penthéréaz;Poliez-Pittet;Rueyres;Saint-Barthélemy (VD);Villars-le-Terroir;Vuarrens;Montilliez;Goumoëns;Boulens;Ogens;Montanaire;Jorat-Menthue;Oppens
District du Jura-Nord vaudois: Bonvillars;Bullet;Champagne;Concise;Corcelles-près-Concise;Fiez;Fontaines-sur-Grandson;Giez;Grandevent;Grandson;Mauborget;Mutrux;Novalles;Onnens (VD);Provence;Sainte-Croix;Tévenon;L'Abergement;Agiez;Arnex-sur-Orbe;Ballaigues;Baulmes;Bavois;Bofflens;Bretonnières;Chavornay;Les Clées;Croy;Juriens;Lignerolle;Montcherand;Orbe;La Praz;Premier;Rances;Romainmôtier-Envy;Sergey;Valeyres-sous-Rances;Vallorbe;Vaulion;Vuiteboeuf;L'Abbaye;Le Chenit;Le Lieu;Belmont-sur-Yverdon;Bioley-Magnoux;Chamblon;Champvent;Chavannes-le-Chêne;Chêne-Pâquier;Cheseaux-Noréaz;Cronay;Cuarny;Démoret;Donneloye;Ependes (VD);Mathod;Molondin;Montagny-près-Yverdon;Orges;Orzens;Pomy;Rovray;Suchy;Suscévaz;Treycovagnes;Ursins;Valeyres-sous-Montagny;Valeyres-sous-Ursins;Villars-Epeney;Vugelles-La Mothe;Yverdon-les-Bains;Yvonand
District de Lausanne: Cheseaux-sur-Lausanne;Epalinges;Jouxtens-Mézery;Lausanne;Le Mont-sur-Lausanne;Romanel-sur-Lausanne
District de Lavaux-Oron: Belmont-sur-Lausanne;Paudex;Pully;Chexbres;Forel (Lavaux);Lutry;Puidoux;Rivaz;Saint-Saphorin (Lavaux);Savigny;Bourg-en-Lavaux;Maracon;Montpreveyres;Servion;Oron;Jorat-Mézières
District de Morges: Aubonne;Ballens;Berolle;Bière;Bougy-Villars;Féchy;Gimel;Mollens (VD);Saint-Livres;Saint-Oyens;Saubraz;La Chaux (Cossonay);Chavannes-le-Veyron;Chevilly;Cossonay;Cuarnens;Dizy;Eclépens;Ferreyres;Gollion;Grancy;L'Isle;Mauraz;Moiry;Mont-la-Ville;Montricher;Orny;Pompaples;La Sarraz;Senarclens;Aclens;Bremblens;Buchillon;Chigny;Clarmont;Denens;Denges;Echandens;Echichens;Etoy;Lavigny;Lonay;Lully (VD);Lussy-sur-Morges;Morges;Préverenges;Romanel-sur-Morges;Saint-Prex;Tolochenaz;Vaux-sur-Morges;Villars-sous-Yens;Vufflens-le-Château;Vullierens;Yens;Hautemorges;Allaman
District de Nyon: Longirod;Marchissy;Saint-George;Arnex-sur-Nyon;Arzier-Le Muids;Bassins;Begnins;Bogis-Bossey;Borex;Chavannes-de-Bogis;Chavannes-des-Bois;Chéserex;Coinsins;Commugny;Coppet;Crans (VD);Crassier;Duillier;Eysins;Founex;Genolier;Gingins;Givrins;Gland;Grens;Mies;Nyon;Prangins;La Rippe;Saint-Cergue;Signy-Avenex;Tannay;Trélex;Le Vaud;Vich;Bursinel;Bursins;Burtigny;Dully;Essertines-sur-Rolle;Gilly;Luins;Mont-sur-Rolle;Perroy;Rolle;Tartegnin;Vinzel
District de l'Ouest lausannois: Crissier;Prilly;Renens (VD);Bussigny;Chavannes-près-Renens;Ecublens (VD);Saint-Sulpice (VD);Villars-Sainte-Croix
District de la Riviera-Pays-d'Enhaut: Château-d'Oex;Rossinière;Rougemont;Chardonne;Corseaux;Corsier-sur-Vevey;Jongny;Montreux;La Tour-de-Peilz;Vevey;Veytaux;Blonay - Saint-Légier
Bezirk Brig: Brig-Glis;Eggerberg;Naters;Ried-Brig;Simplon;Termen;Zwischbergen
District de Conthey: Ardon;Chamoson;Conthey;Nendaz;Vétroz
District d'Entremont: Bourg-Saint-Pierre;Liddes;Orsières;Sembrancher;Val de Bagnes
Bezirk Goms: Bellwald;Binn;Ernen;Fiesch;Fieschertal;Lax;Obergoms;Goms
District d'Hérens: Ayent;Evolène;Hérémence;Saint-Martin (VS);Vex;Mont-Noble
Bezirk Leuk: Agarn;Albinen;Ergisch;Inden;Leuk;Leukerbad;Oberems;Salgesch;Varen;Guttet-Feschel;Gampel-Bratsch;Turtmann-Unterems
District de Martigny: Bovernier;Fully;Isérables;Leytron;Martigny;Martigny-Combe;Riddes;Saillon;Saxon;Trient
District de Monthey: Champéry;Collombey-Muraz;Monthey;Port-Valais;Saint-Gingolph;Troistorrents;Val-d'Illiez;Vionnaz;Vouvry
Bezirk Raron: Bister;Bitsch;Grengiols;Riederalp;Ausserberg;Blatten;Bürchen;Eischoll;Ferden;Kippel;Niedergesteln;Raron;Unterbäch;Wiler (Lötschen);Mörel-Filet;Steg-Hohtenn;Bettmeralp
District de Saint-Maurice: Collonges;Dorénaz;Evionnaz;Finhaut;Massongex;Saint-Maurice;Salvan;Vernayaz;Vérossaz
District de Sierre: Chalais;Chippis;Grône;Icogne;Lens;Saint-Léonard;Sierre;Anniviers;Crans-Montana;Noble-Contrée
District de Sion: Arbaz;Grimisuat;Savièse;Sion;Veysonnaz
Bezirk Visp: Baltschieder;Eisten;Embd;Grächen;Lalden;Randa;Saas-Almagell;Saas-Balen;Saas-Fee;Saas-Grund;St. Niklaus;Stalden (VS);Staldenried;Täsch;Törbel;Visp;Visperterminen;Zeneggen;Zermatt
Canton de Neuchâtel: Boudry;Cortaillod;Rochefort;Milvignes;La Grande Béroche;La Chaux-de-Fonds;Les Planchettes;La Sagne;La Brévine;Brot-Plamboz;Le Cerneux-Péquignot;La Chaux-du-Milieu;Le Locle;Les Ponts-de-Martel;Cornaux;Cressier (NE);Enges;Hauterive (NE);Le Landeron;Lignières;Neuchâtel;Saint-Blaise;La Tène;Val-de-Ruz;La Côte-aux-Fées;Les Verrières;Val-de-Travers
Canton de Genève: Aire-la-Ville;Anières;Avully;Avusy;Bardonnex;Bellevue;Bernex;Carouge (GE);Cartigny;Céligny;Chancy;Chêne-Bougeries;Chêne-Bourg;Choulex;Collex-Bossy;Collonge-Bellerive;Cologny;Confignon;Corsier (GE);Dardagny;Genève;Genthod;Le Grand-Saconnex;Gy;Hermance;Jussy;Laconnex;Lancy;Meinier;Meyrin;Onex;Perly-Certoux;Plan-les-Ouates;Pregny-Chambésy;Presinge;Puplinge;Russin;Satigny;Soral;Thônex;Troinex;Vandoeuvres;Vernier;Versoix;Veyrier
District de Delémont: Boécourt;Bourrignon;Châtillon (JU);Courchapoix;Courrendlin;Courroux;Courtételle;Delémont;Develier;Ederswiler;Mervelier;Mettembert;Movelier;Pleigne;Rossemaison;Saulcy;Soyhières;Haute-Sorne;Val Terbi
District des Franches-Montagnes: Le Bémont (JU);Les Bois;Les Breuleux;Les Enfers;Les Genevez (JU);Lajoux (JU);Montfaucon;Muriaux;Le Noirmont;Saignelégier;Saint-Brais;Soubey
District de Porrentruy: Alle;Beurnevésin;Boncourt;Bonfol;Bure;Coeuve;Cornol;Courchavon;Courgenay;Courtedoux;Fahy;Fontenais;Grandfontaine;Porrentruy;Vendlincourt;Basse-Allaine;Clos du Doubs;Haute-Ajoie;La Baroche;Damphreux-Lugnez
